111111
1P0001
101C01
100GE1
111111