111111
1P0001
101CE1
1000G1
111111