1111111111111111111111111111111111
1E000000000G000C00000C000000G00001
1010010100100000101001000000010101
1010010010101010001001000000010101
1P000G000C00C00000000000000G0000C1
1111111111111111111111111111111111