1111111111111
10010000G00C1
10G0011111001
1P0011E000001
1111111111111