11111111111111111111111
1C0000000000001000G0001
1000000E00000000000C001
1101110000111100C000001
10000000001111000000001
1111111100011100P000001
1000000G000001000000001
10C00000000001000G00001
1101110000111100000C001
10000000000C00000000001
11111111111111111111111