1111111111111
1000E000C00C1
1010101010101
1P10101010101
1111111111111
1111111111111